1111111
1000001
1000001
1000001
1000001111
100N000001
1000001101
1000001101
1111111111
