

F 255,165,0

C 255,127,80

NO ./path_to_the_south_texture
SO ./path_to_the_south_texture
EA ./path_to_the_south_texture
WE ./path_to_the_south_texture


111111111
100000001
100000001
100000001
100000001
100000001
100000001
100000001
100000001
100000111111111111111111
100S00000000000000000001
100000110111111111111111
1000001101
1111111111
