1111111111111111111111
1000000000000000000001
1000000000000000000001
1000000000000000000001
1000000000000000000001
1000000000000001100001
1000000000000000000001
1000000000000000000001
10000000000000000000011
111111111111111000000011111111111111111
100000000000000000N00000000000000000001
111111111111111000000011111111111111111
         11111111111111

