F 34,139,34

C 30,144,5

NO img/testmc/1.xpm
SO img/testmc/0.xpm
EA img/testmc/E.xpm
WE img/testmc/E2.xpm

11111111111111111111111111111111111111111111111111111111111111111111111111111111111111
1000000000000000000000000000000000000000000000000000000000000110000D000000000000000001
10100000000000000000000000000000000000000000000000000000000001101101100000000000000001
10010000000000000000000000000000000000000000000000000000000000110110100000000000000001
100D000000000001000000000000001111111111111110111111111111111110110D000000000000000001
10011111111111000001111111111111111111111111100000000000000000000101100000000000000001
1101111111111101111111111111111111111111111111D11111111111111111010111111D111111111101
1000000000001001000000000000000000000000000000000000000000000DD00101100000000000000001
10000000000010010000000000000000000000000000000000000000000001100101110000000000000001
10000000000011110000000000000000000000000000000000000000000001001101100000000000000001
10000000000000000000000000000000000000000000000000000000000001011101000000000000000001
1111111D111111111111111111000000001111111111111111111111111110011101000000000000000001
1000000000000000000000000000000000000000000000000000000000000D011101000000000000000001
10100000000000000000000000000000000000000000000000000000000001001101000000000000000001
10100000000000000000000000000000000000000000000000000111111111011101000000000000000001
10100000000000010000000000000011111111111111101111111111000000011101100000000000000001
10111111D11111000001N11111111111111111111111101111111110011111000101000000000000000001
10000000000010010000000000000000000000000000000000000000000001110000001000000000000001
10000000000010010000000000000000000000000000000000000000000000000010101000000000000001
10000000000011110000000000000000000000000000000000000000000000001110101000000000000001
10000000000000000000000000000000000000000000000000000000000000000000100010000000000001
10000000000000000000000000000000000000000000000000000000000000000000100010000000000001
10000000000000000000000000000000000000000000000000000000000000000000100010000000000001
10000000000000000000000000000000000000000000000000000000000000000000100010000000000001
10000000000000000000000000000000000000000000000000000000000000000000100010000000000001
11111111111111111111111111111111111111111111111111111111111111111111111111111111111111