

F 255,165,0

C 255,99,80

NO img/brique/small_north.xpm
SO img/brique/small_south.xpm
EA img/brique/east_smaller_wall.xpm
WE img/brique/smaller_west.xpm


111111111111111111111111
100000000000000000000001
100000000000000000000001
100000000000000000000001
100000000001D11000000001
100000000000000000000001
100000000000000000000001
100000000000000000000001
100000000000000000000001
1000001111111D1111111111
100N00000000000000000001
10000011011111D111101001
100000DD0000000000000001
111111111111111111111111
